SampleID	Golay Barcode	BarcodeSequence
Camposta.1	ATGTTAGGGAAT	ATGTTAGG
Camposta.2	AAGTGGCTATCC	AAGTGGCT
Camposta.3	GTCGTTACCCGC	GTCGTTAC
Camposta.4	AGTATATGTTTC	AGTATATG
Camposta.5	GGCTCGTCGGAG	GGCTCGTC
Gandules.K2	GACATCTGACAC	GACATCTG
Gandules.K3	AATTTCCTAACA	AATTTCCT
Gandules.K4	ATAAACGGACAT	ATAAACGG
Gandules.K6	GCTAGTTATGGA	GCTAGTTA
Maravilla.F1	ACTAGTTGGACC	ACTAGTTG
Maravilla.F3	CGCAAGCCCGCG	CGCAAGCC
Maravilla.F4	AGAGCGGAACAA	AGAGCGGA
Maravilla.F5	ACATGGGCGGAA	ACATGGGC
Girasoles.E5	CTGCGGATATAC	CTGCGGAT
Girasoles.E10	GTGAGGGCAAGT	GTGAGGGC
Girasoles.G6	ATATTGGCAGCC	ATATTGGC
Girasoles.G9	TCATCCGTCGGC	TCATCCGT
HerbaGuinea.d1	GGCTTCGGAGCG	GGCTTCGG
HerbaGuinea.d3	CGGTCAATTGAC	CGGTCAAT
HerbaGuinea.d4	TCCGCTGCTGAC	TCCGCTGC
HerbaGuinea.5	TGCGCGCCTTCC	TGCGCGCC
Cosmo.T.A1	GCGCACACCTTC	GCGCACAC
Cosmo.T.A5	CACGAAAGCAGG	CACGAAAG
Cosmo.T.C3	CGTGGCTTTCCG	CGTGGCTT
Cosmo.T.A9	ATTTGGCTCTTA	ATTTGGCT
Cosmo.T.C7	CGCGTCAAACTA	CGCGTCAA
Tobacco.B4	ATGTTCCTCATC	ATGTTCCT
Tobacco.B5	TCCGTGGTATAG	TCCGTGGT
Tobacco.B1	GTTGGTTGGCAT	GTTGGTTG
Tobacco.B3	AACGGGCGACGT	AACGGGCG
Tobacco.B2	TACTGAGCCTCG	TACTGAGC
